###################################################
#                                                 #
#                                                 #
#                                                 #
#                                                 #
#                                                 #
#   [                                             #
#                                                 #
#         ###                                     #
#         #######                          *      #
#         #######                          m      #
#################                        #####    #
#################           p            #####    #
#################           *            #####    #
#################                     ########    #
#################                     ########    #
#################                     ########    #
#################                     ########    #
#################                     ########    #
#################                     #######     #
#################   ###############   ######      #
####################               ########       #
#                                                 #
#                                                 #
#                                                 #
#                                           b     #
#                                           *     #
#                                                 #
#                                                 #
#                                          ###    #
#                                          ###    #
#                                    #########    #
#                                   ###############
#                                  ################
#              1 1    1 1    1 1 1 ################
#         #########################################
#]        #########################################
###################################################